...#####.....#####................#####.....#####........
!Eeee!Eeee!Eeee!Eeee!Eeee!Ee!Ee!Eeee!Eeee!Eeee!Eeee!Eeee!
n....S....n....S....n....S.....n....S....n....S....n....S
n....s....n....s....n....s.....n....s....n....s....n....s
n#...s....n....s....n....s.....n#...s....n....s....n....s
N.#..s....N....s....N....s.....N.#..s....N....s....N....s
!wwwW!wwwW!wwwW!wwwW!wwwW!wW!wW!wwwW!wwwW!wwwW!wwwW!wwwW!
.......#####......#####..S.....n.......#####.....#####...
.........................s.....n.........................
...#####.....#####.......s.....N..#####.....#####........
!Eeee!Eeee!Eeee!Eeee!Eeee!Ee!Ee!Eeee!Eeee!Eeee!Eeee!Eeee!
n....S....n....S....n....S.....n....S....n....S....n....S
n....s....n....s....n....s.....n....s....n....s....n....s
n#...s....n....s....n....s.....n#...s....n....s....n....s
N.#..s....N....s....N....s.....N.#..s....N....s....N....s
!wwwW!wwwW!wwwW!wwwW!wwwW!wW!wW!wwwW!wwwW!wwwW!wwwW!wwwW!
.......#####......#####..S.....n.......#####.....#####...
.........................s.....n.........................
...#####.....#####.......s.....N..#####.....#####........
!Eeee!Eeee!Eeee!Eeee!Eeee!Ee!Ee!Eeee!Eeee!Eeee!Eeee!Eeee!
n....S....n....S....n....S.....n....S....n....S....n....S
n....s....n....s....n....s.....n....s....n....s....n....s
n#...s....n....s....n....s.....n#...s....n....s....n....s
N.#..s....N....s....N....s.....N.#..s....N....s....N....s
!wwwW!wwwW!wwwW!wwwW!wwwW!wW!wW!wwwW!wwwW!wwwW!wwwW!wwwW!
.......#####......#####..S.....n.......#####.....#####...
.........................s.....n.........................
...#####.....#####.......s.....N..#####.....#####........
!Eeee!Eeee!Eeee!Eeee!Eeee!Ee!Ee!Eeee!Eeee!Eeee!Eeee!Eeee!
n....S....n....S....n....S.....n....S....n....S....n....S
n....s....n....s....n....s.....n....s....n....s....n....s
n#...s....n....s....n....s.....n#...s....n....s....n....s
N.#..s....N....s....N....s.....N.#..s....N....s....N....s
!wwwW!wwwW!wwwW!wwwW!wwwW!wW!wW!wwwW!wwwW!wwwW!wwwW!wwwW!
.......#####......#####..S.....n.......#####.....#####...
.........................s.....n.........................
...#####.....#####.......s.....N..#####.....#####........
!Eeee!Eeee!Eeee!Eeee!Eeee!Ee!Ee!Eeee!Eeee!Eeee!Eeee!Eeee!
n....S....n....S....n....S.....n....S....n....S....n....S
n....s....n....s....n....s.....n....s....n....s....n....s
n#...s....n....s....n....s.....n#...s....n....s....n....s
N.#..s....N....s....N....s.....N.#..s....N....s....N....s
!wwwW!wwwW!wwwW!wwwW!wwwW!wW!wW!wwwW!wwwW!wwwW!wwwW!wwwW!
.......#####......#####..S.....n.......#####.....#####...
.........................s.....n.........................
...#####.....#####.......s.....N..#####.....#####........
!Eeee!Eeee!Eeee!Eeee!Eeee!Ee!Ee!Eeee!Eeee!Eeee!Eeee!Eeee!
n....S....n....S....n....S.....n....S....n....S....n....S
n....s....n....s....n....s.....n....s....n....s....n....s
n#...s....n....s....n....s.....n#...s....n....s....n....s
N.#..s....N....s....N....s.....N.#..s....N....s....N....s
!wwwW!wwwW!wwwW!wwwW!wwwW!wW!wW!wwwW!wwwW!wwwW!wwwW!wwwW!
.......#####......#####..S.....n.......#####.....#####...
.........................s.....n.........................
...#####.....#####.......s.....N..#####.....#####........
!Eeee!Eeee!Eeee!Eeee!Eeee!Ee!Ee!Eeee!Eeee!Eeee!Eeee!Eeee!
n....S....n....S....n....S.....n....S....n....S....n....S
n....s....n....s....n....s.....n....s....n....s....n....s
n#...s....n....s....n....s.....n#...s....n....s....n....s
N.#..s....N....s....N....s.....N.#..s....N....s....N....s
!wwwW!wwwW!wwwW!wwwW!wwwW!wW!wW!wwwW!wwwW!wwwW!wwwW!wwwW!
.......#####......#####..S.....n.......#####.....#####...
.........................s.....n.........................
...#####.....#####.......s.....N..#####.....#####........
!Eeee!Eeee!Eeee!Eeee!Eeee!Ee!Ee!Eeee!Eeee!Eeee!Eeee!Eeee!
n....S....n....S....n....S.....n....S....n....S....n....S
n....s....n....s....n....s.....n....s....n....s....n....s
n#...s....n....s....n....s.....n#...s....n....s....n....s
N.#..s....N....s....N....s.....N.#..s....N....s....N....s
!wwwW!wwwW!wwwW!wwwW!wwwW!wW!wW!wwwW!wwwW!wwwW!wwwW!wwwW!
n......#####......#####..S.....n.......#####.....#####..S
n........................s.....n........................s
N..#####.....#####.......s.....N..#####.....#####.......s
!Eeee!Eeee!Eeee!Eeee!Eeee!Ee!Ee!Eeee!Eeee!Eeee!Eeee!Eeee!
n....S....n....S....n....S.....n....S....n....S....n....S
n....s....n....s....n....s.....n....s....n....s....n....s
n#...s....n....s....n....s.....n#...s....n....s....n....s
N.#..s....N....s....N....s.....N.#..s....N....s....N....s
!wwwW!wwwW!wwwW!wwwW!wwwW!wW!wW!wwwW!wwwW!wwwW!wwwW!wwwW!
........#####.....#####................#####.....#####...
.........................................................