..###...###..
!Eeeee!Eeeee!
n..p..S..p..n
n.....sp....n
n#....sp...#n
n.....s.....n
N#.p..s..p..N
!wwwwW!wwwwW!
..ttt...ttt..