..###...###..
!Eeeee!Eeeee!
n..p..S..p..S
n.....sp....s
n#....sp...#s
n.....s.....s
N#.p..s..p..s
!wwwwW!wwwwW!
..ttt...ttt..