....###.......###.......###.........
!Eeee!Eeee!Eeee!Eeee!Eeee!Eeee!Eeee!
n#...S....n....S....n....S....n..#.S
n....s....n....s....n....s....n..##s
n....s....n....s....n....s....n....s
N#...s....N#...s....N....s....N....s
!wwwW!wwwW!wwwW!wwwW!wwwW!wwwW!wwwW!
